┌───┬─────■──┐
│▓▓t│▓▓▓f▓ ▓f│
│▓▓▓│▓▓▓▓▓ ▓▓│
│«»B│<-> ¶ ¶ │
│   │  ·    c│
│  ♣│c    p  │
├─ ─┴──── ───┤
│▓ ▓f▓▓f▓ ▓▓▓│
│gD▓▓▓▓▓▓D▓g▓│
│╔╦╗    ╔╦╗ P│
│╚╩╝    ╚╩╝  │
│c   c  c   c│
├─────▲▲─────┤
│▓▓▓▓f▲▲f▓▓▓▓│
│w▓g▓▓  ▓▓g▓w│
│k¶ ¶ ╔╗ ¶ ¶ │
│c    ╠╣    c│
├─♣  ¶╠╣¶  ♣─┤
│▓    ╠╣    ▓│
│w♣   ╠╣   ♣w│
│    ¶╠╣¶    │
│c    ╚╝    c│
└─────▼▼─────┘